XXXXXXXXXX
________XX
XXXXX_XX_X
_______X_X
XX_XXXXX_X
XX_X___X_X
XX_X_XXX_X
_____X___X
XXXX_X_X_X
XXXXXXXXXX
