XXXXXXXXXX
XXXXXXXXXX
XXX_XXXXXX
XXX_XXXXXX
XXXX_XXXXX
XXXX____XX
XXXXXXX_XX
XXXXXX__XX
XXXXXXXXXX
XX______XX
