XXXXXXXXXXXXXXXXXXXX
XXX_X_______XXXXXXXX
XXX_XXXXXXX_XXX_XXXX
XXX_XXXXXXX_XXX_XXXX
XXX_______X_XXXXXXXX
XXXXXXXXX_X_XXXXXXXX
XXXXXXXXX_X_XXXXXXXX
XX___XXXX_X_XXXXXXXX
_XXX_XXXX_X_XXXXXXXX
_XXX_X_XX_X_XXXXXXXX
_XXX_X_XX___XXXXXXXX
_XXX_X_XXXX_XXXXXXXX
____________________
XXXXXXXXXXXXXXXXXXXX
XXXXXXXXXXXXXXXXXXXX
XXXXXXXXXXXXXXXXXXXX
XXXXXXXXXXXXXXXXXXXX
XXXXXXXXXXXXXXXXXXXX
XXXXXXXXXXXXXXXXXXXX
XXXXXXXXXXXXXXXXXXXX